NO ./path_to_the_north_texture1
SO ./path_to_the_south_texture2
WE ./path_to_the_west_texture3
EA ./path_to_the_east_texture4

F 10,10,10
C 255,255,255


1111111111111111111111111
1000000000110000000000001
1011000001110000002000001
1001000000000000000000001
1111111110110000011100001
1000000000110000011101111
1111011111111101110000001
1111011111111101110101001
1100000011010101110000001
1000200000000000110000001
1000000000N00000110101001
1100000111010101111101101
1111011111110101110111101
1111011111111111110111111