NO ./path_to_the_north_texture1
SO ./path_to_the_south_texture2
WE ./path_to_the_west_texture3
EA ./path_to_the_east_texture4

F 10,10,10
C 255,255,255

111111111111111111111111111111111
100000000000000N00001111000000001
100000000000000000001  1000000001
111111111101111111111  1110111111
111111111101111                  
110000000000001
111111111111111